0,123,107,143,73,74,74,74,74,74,74,74,74,74,74,60,74,74,74,74,74,75,18,19,84,105,35,104,119,105,36,18
140,107,143,56,74,74,74,60,74,74,74,59,74,74,74,77,74,74,91,91,91,92,103,89,96,67,65,66,67,34,19,36
107,143,123,73,59,74,74,77,74,91,91,76,91,91,91,91,91,91,92,93,105,103,19,72,89,84,82,18,84,94,18,103
143,106,56,74,76,74,91,91,91,92,90,91,92,19,0,19,34,19,34,105,105,34,68,17,0,96,98,105,96,66,66,67
57,57,74,74,74,91,92,105,89,0,51,35,36,51,51,51,105,0,94,35,17,122,19,17,34,36,34,119,68,36,122,84
74,60,74,91,92,122,89,94,17,36,103,105,0,17,35,94,36,94,94,93,104,68,34,18,104,51,104,0,122,119,103,84
74,77,91,92,68,35,122,104,93,93,36,0,119,105,18,36,102,51,68,19,18,68,103,102,102,51,17,17,51,51,105,84
74,74,92,122,72,122,94,19,93,107,109,68,0,35,105,122,103,17,94,105,119,105,68,35,103,105,93,94,51,34,62,101
91,92,89,17,0,19,19,122,107,110,125,109,34,93,51,17,93,51,0,19,93,36,68,68,94,102,34,51,18,104,79,35
75,72,93,68,19,103,17,107,125,127,110,126,94,34,51,36,68,19,122,18,35,0,104,19,119,93,104,36,0,93,79,68
75,0,103,19,103,36,35,141,142,142,142,143,34,0,34,18,105,36,102,94,119,35,36,68,17,68,105,35,105,36,79,94
75,72,105,72,102,103,140,106,106,36,34,35,35,19,34,17,93,103,17,122,34,104,103,104,0,102,119,102,19,140,79,104
59,58,35,36,68,102,17,119,123,140,38,68,94,19,103,103,105,34,105,19,119,94,119,122,119,17,62,100,100,64,79,104
76,75,105,17,34,93,105,106,93,35,5,7,34,17,103,137,68,116,117,117,119,103,119,105,34,102,84,17,17,99,101,18
74,92,104,103,104,35,17,18,0,5,8,23,7,122,105,117,117,132,122,122,105,17,105,119,103,122,84,122,2,103,119,19
75,74,58,19,93,68,19,68,0,39,25,8,24,103,102,102,103,135,120,103,17,105,119,102,34,122,84,103,150,117,117,117
90,74,75,51,103,17,51,36,19,103,39,25,24,34,0,17,102,119,105,105,122,122,105,119,102,17,96,66,67,122,34,19
19,90,75,103,19,105,18,93,93,102,38,39,41,21,119,103,102,103,103,105,102,119,34,103,34,102,17,94,96,67,34,56
16,56,75,119,94,102,34,51,94,35,38,5,6,7,38,105,102,122,122,105,17,17,104,122,122,34,122,17,119,84,102,90
28,90,92,119,34,20,18,37,37,3,5,23,23,24,38,102,119,105,102,34,17,105,104,104,119,34,122,94,105,96,66,67
33,51,94,3,2,122,135,34,3,5,23,9,23,23,7,119,105,104,104,34,104,122,105,93,94,51,105,122,17,68,105,84
45,15,16,117,117,117,132,3,3,22,8,26,8,23,24,103,102,122,104,119,17,104,103,62,64,105,62,63,64,35,103,84
32,32,33,51,2,93,135,105,102,22,25,9,25,23,24,4,104,34,119,122,102,102,104,79,99,100,101,123,99,100,100,101
32,32,33,19,105,93,94,119,19,39,40,26,23,9,23,6,7,17,104,34,17,105,17,84,19,123,102,35,36,36,35,18
27,32,33,36,103,36,17,34,105,94,21,39,23,26,23,9,24,105,34,17,17,122,103,96,97,67,34,18,34,18,34,34
10,32,45,16,102,18,94,19,17,51,51,4,39,23,9,26,24,105,94,68,104,122,94,17,102,84,17,89,17,34,35,34
27,27,32,45,16,19,102,51,35,17,51,1,38,22,26,8,23,7,0,105,93,103,119,93,119,84,18,17,36,35,36,35
10,27,32,32,45,16,104,36,102,103,117,118,103,22,8,25,23,24,4,93,94,94,34,51,51,96,66,67,35,89,65,66
12,13,10,32,32,45,15,16,122,93,18,135,35,39,25,9,23,23,7,93,119,35,119,18,51,93,35,96,66,66,98,17
29,31,27,27,32,32,32,33,19,102,119,135,121,93,39,26,8,23,24,35,21,19,36,103,119,18,18,34,19,34,51,0
106,48,12,13,10,32,32,45,16,122,68,150,118,122,4,22,25,23,24,19,94,36,119,0,122,36,34,18,105,93,17,36
29,29,34,30,27,27,32,32,45,16,0,122,135,102,18,22,23,23,24,4,103,105,17,19,104,17,35,36,119,36,0,119
